12 12 12 12 12 12 12 12 12 12 12 12 12 12 12 12 12 12 12 12 12 12 12 12 12 12 12 12 12 12 12 12 12 12 12 12 12 12 12 12 12 12 12 12 12 12 12 12 12 12 
12 12 12 12 12 12 12 12 12 12 12 12 12 12 12 12 12 12 12 12 12 12 12 12 12 12 12 12 12 12 12 12 12 12 12 12 12 12 12 12 12 12 12 12 12 12 12 12 12 12 
12 12 12 12 12 12 12 12 12 12 12 12 12 12 12 12 12 12 12 12 12 12 12 12 12 12 12 12 12 12 12 12 12 12 12 12 12 12 12 12 12 12 12 12 12 12 12 12 12 12 
12 12 12 12 12 12 12 15 15 12 15 15 15 15 15 15 15 12 12 12 12 12 12 12 15 15 15 15 15 15 12 12 12 12 12 12 12 12 12 12 12 12 12 12 12 12 12 12 12 12 
12 12 12 15 15 15 15 15 15 15 15 15 15 15 15 15 15 15 15 15 15 15 15 15 15 15 15 15 15 15 15 15 15 15 15 15 15 15 15 15 15 15 15 15 15 15 12 12 12 12 
12 12 12 15 15 15 15 15 15 15 15 15 15 15 15 15 15 15 15 15 15 15 15 15 15 15 15 15 15 15 15 15 15 15 15 15 15 15 15 15 15 15 15 15 15 15 15 12 12 12 
12 12 12 15 15 16 16 16 16 16 16 16 16 16 16 16 16 16 16 16 16 16 16 16 16 16 16 16 16 16 16 16 16 16 16 16 16 16 16 16 16 16 16 16 16 16 15 12 12 12 
12 12 12 15 15 16 10 9 9 9 9 9 9 9 11 11 11 11 11 11 11 11 15 11 11 11 11 11 11 11 11 11 11 11 11 15 11 11 11 11 11 11 11 11 11 16 15 12 12 12 
12 12 15 15 15 16 10 9 9 9 9 9 9 9 11 11 11 11 11 11 11 11 15 11 11 11 11 11 11 11 11 11 11 11 11 15 11 11 11 11 11 11 11 11 11 16 15 12 12 12 
12 12 12 15 15 16 10 9 9 9 9 9 9 9 11 11 11 11 11 11 11 11 15 11 11 11 11 11 11 11 11 11 11 11 11 15 11 11 11 11 11 11 11 11 11 16 15 12 12 12 
12 12 12 15 15 16 10 9 9 9 15 15 15 15 15 15 15 15 15 10 11 10 15 15 15 15 15 15 10 10 10 15 11 11 11 15 10 10 11 15 15 15 10 11 11 16 16 15 12 12 
12 12 12 15 15 15 16 9 9 9 15 9 9 9 11 11 11 11 11 11 11 10 15 11 11 11 11 11 11 11 10 15 11 11 11 11 11 11 11 15 11 11 11 11 11 16 16 15 12 12 
12 12 12 15 15 15 16 9 9 9 15 9 9 9 11 11 11 11 11 11 11 10 15 11 11 11 11 11 11 11 10 15 11 11 11 11 11 11 11 15 11 11 11 11 11 15 16 15 12 12 
12 12 15 15 15 15 16 9 9 9 15 9 9 9 15 15 15 15 15 15 15 15 15 11 11 11 11 11 11 11 10 15 11 11 11 11 11 11 11 15 11 11 11 11 11 16 16 15 12 12 
12 12 15 15 15 16 16 9 9 9 15 9 9 9 11 11 11 11 11 11 11 11 15 11 11 11 15 15 15 15 15 15 15 15 15 15 15 15 15 15 15 15 11 11 11 16 15 15 12 12 
12 12 15 15 15 15 16 9 9 9 15 9 9 9 11 11 11 11 11 11 11 11 15 11 11 11 15 11 11 11 11 11 11 11 11 11 11 11 11 11 11 15 11 11 11 16 15 15 12 12 
12 12 12 15 15 15 16 9 9 9 15 9 9 9 11 11 11 11 11 11 11 11 15 11 11 11 15 11 11 11 11 11 11 11 11 11 11 11 11 11 11 15 11 11 11 16 15 15 12 12 
12 12 12 15 15 15 16 9 9 9 15 15 15 15 15 15 15 15 15 11 11 11 15 11 11 11 15 15 15 15 15 15 15 15 15 15 15 11 11 11 11 15 11 11 11 16 15 12 12 12 
12 15 12 15 15 15 16 9 9 9 9 9 9 9 11 11 11 11 15 11 11 11 15 11 11 11 11 11 11 11 11 11 11 11 11 11 15 11 11 11 11 15 11 11 11 16 15 15 12 12 
15 15 12 15 15 15 16 9 9 9 9 9 9 9 11 11 11 11 15 11 11 11 15 11 11 11 11 11 11 11 11 11 11 11 11 11 15 10 11 10 11 15 11 11 11 16 15 15 15 12 
15 15 15 15 15 15 16 16 9 9 9 9 9 9 11 11 11 11 11 11 11 11 15 11 11 11 11 11 11 11 11 11 11 11 11 10 15 11 11 11 11 11 10 10 10 16 16 16 16 16 
15 15 15 15 15 15 16 16 15 15 15 15 15 15 15 11 11 11 15 11 11 11 15 15 15 15 15 15 15 15 15 15 15 11 11 10 15 11 11 11 11 10 10 10 10 15 10 10 10 10 
4 4 4 4 4 4 9 9 9 9 9 9 9 9 15 11 11 11 15 11 11 11 11 11 11 11 11 11 15 11 11 11 15 11 10 10 15 11 10 10 10 10 10 10 10 15 10 10 10 10 
4 4 4 4 4 4 9 9 9 9 9 9 9 9 15 11 11 11 15 11 11 11 11 11 11 11 11 11 15 11 11 11 15 11 10 10 15 10 10 10 10 10 10 10 10 15 10 10 10 10 
4 4 4 4 4 4 10 10 10 10 10 10 10 10 15 11 11 11 15 11 11 11 11 11 11 11 11 11 15 11 11 11 15 11 10 10 15 10 10 10 15 15 15 15 15 15 10 10 10 10 
4 4 4 4 4 4 10 10 10 10 10 10 10 10 15 11 11 11 15 11 11 11 15 15 15 15 15 15 15 11 11 11 15 11 10 10 15 10 10 10 10 10 10 10 10 10 10 10 10 10 
4 4 4 4 4 4 10 10 10 10 10 10 10 10 15 11 11 11 15 11 11 11 11 11 11 11 11 11 11 11 11 11 15 11 11 10 15 10 10 10 10 10 10 10 10 10 10 10 10 10 
15 15 15 15 15 15 16 10 10 10 15 10 10 10 15 11 11 11 15 11 11 11 11 11 11 11 11 11 11 11 11 11 15 11 10 10 15 10 10 10 10 10 10 10 10 10 10 10 10 10 
15 15 15 15 15 15 16 10 10 10 15 10 10 10 15 11 11 11 15 11 11 11 11 11 11 11 11 11 11 11 11 11 15 11 10 10 15 15 15 15 15 15 15 15 15 10 16 16 16 16 
15 15 15 15 15 15 16 10 10 10 15 10 10 10 15 11 11 11 15 15 15 15 15 15 15 15 15 15 15 11 11 11 15 11 11 11 11 11 11 11 11 11 11 11 8 10 16 15 15 12 
12 15 15 15 12 15 16 10 10 10 15 10 10 10 15 11 11 11 15 11 11 11 11 11 10 10 10 11 11 11 11 11 15 11 11 11 11 11 11 11 11 11 11 11 8 10 16 15 12 12 
12 13 15 12 13 15 16 10 10 10 15 10 10 10 15 11 11 11 15 11 11 11 11 11 11 11 11 11 11 11 11 11 15 11 11 11 11 11 11 11 11 11 11 11 8 10 16 15 15 12 
12 13 12 13 12 15 16 10 10 10 15 10 10 10 15 11 11 11 15 11 11 11 11 11 11 11 11 11 11 11 11 11 15 11 11 11 11 11 11 11 11 11 11 11 8 10 16 15 15 12 
12 13 12 12 13 15 16 10 10 10 15 10 10 10 15 11 11 11 15 11 11 11 15 15 15 15 15 15 15 15 15 15 15 15 15 15 15 15 11 11 11 15 11 11 11 10 16 15 15 12 
13 12 13 12 13 15 16 10 10 10 15 10 10 10 9 11 11 11 15 11 11 11 11 11 11 11 11 11 11 11 11 11 15 11 11 11 11 11 11 11 11 15 11 11 11 11 16 15 12 12 
12 13 12 12 13 15 16 10 10 10 15 10 10 10 9 11 11 11 15 11 11 11 11 11 11 11 11 11 11 11 11 11 15 11 11 11 11 11 11 11 11 15 11 11 11 11 16 15 12 12 
12 13 12 12 13 15 16 10 10 10 15 10 10 10 11 11 11 11 15 11 11 11 11 11 11 11 11 11 11 11 11 11 15 11 11 11 11 11 11 11 11 15 11 11 11 11 16 15 15 12 
12 12 13 12 12 15 16 10 10 10 15 15 15 15 15 15 15 15 15 10 10 10 15 15 15 15 15 15 15 11 11 11 15 10 10 10 15 15 15 15 15 15 11 11 10 11 16 15 15 12 
12 13 12 12 13 15 16 10 10 10 10 10 10 10 11 11 15 11 11 11 11 11 11 11 11 11 15 11 11 11 11 11 9 11 11 11 15 11 11 11 11 11 11 11 11 11 16 15 15 12 
13 13 12 13 12 15 16 10 10 10 10 10 10 10 11 11 15 11 11 11 11 11 11 11 11 11 15 11 11 11 11 11 9 11 11 11 15 11 11 11 11 11 11 11 11 11 16 15 15 12 
12 12 12 12 12 15 16 10 10 10 10 10 10 10 11 11 15 11 11 11 11 11 11 11 11 11 15 11 11 11 11 11 9 11 11 11 15 11 11 11 11 11 11 11 11 11 16 15 15 12 
12 12 12 12 12 15 16 16 16 16 16 16 16 16 16 16 16 16 16 16 16 16 16 16 16 16 16 16 16 16 16 16 16 16 16 16 16 16 16 16 16 16 16 16 16 16 16 15 15 12 
12 12 12 12 12 15 15 15 15 15 15 15 15 15 15 15 15 15 15 15 15 15 15 15 15 15 15 15 15 15 15 15 15 15 15 15 15 15 15 15 15 15 15 15 15 15 15 15 12 12 
12 12 12 12 12 7 6 6 6 6 6 6 6 6 6 6 6 6 6 6 6 6 6 6 6 6 6 6 6 6 6 6 6 6 6 6 6 6 6 6 6 6 6 6 6 6 12 12 12 12 
12 12 12 12 12 12 12 12 12 12 12 12 12 12 12 12 12 12 12 12 12 12 12 12 12 12 12 12 12 12 12 12 12 12 12 12 12 12 12 12 12 12 12 12 12 12 12 12 12 12 
12 12 12 12 12 12 12 12 12 12 12 12 12 12 12 12 12 12 12 12 12 12 12 12 12 12 12 12 12 12 12 12 12 12 12 12 12 12 12 12 12 12 12 12 12 12 12 12 12 12 
12 12 12 12 12 12 12 12 12 12 12 12 12 12 12 12 12 12 12 12 12 12 12 12 12 12 12 12 12 12 12 12 12 12 12 12 12 12 12 12 12 12 12 12 12 12 12 12 12 12 
12 12 12 12 12 12 12 12 12 12 12 12 12 12 12 12 12 12 12 12 12 12 12 12 12 12 12 12 12 12 12 12 12 12 12 12 12 12 12 12 12 12 12 12 12 12 12 12 12 12 
12 12 12 12 12 12 12 12 12 12 12 12 12 12 12 12 12 12 12 12 12 12 12 12 12 12 12 12 12 12 12 12 12 12 12 12 12 12 12 12 12 12 12 12 12 12 12 12 12 12 
12 12 12 12 12 12 12 12 12 12 12 12 12 12 12 12 12 12 12 12 12 12 12 12 12 12 12 12 12 12 12 12 12 12 12 12 12 12 12 12 12 12 12 12 12 12 12 12 12 12 
