2 2 2 2 2 2 2 2 2 2 2 2 2 2 2 2 2 2 2 2 2 2 2 2 2 2 2 2 2 2 2 2 2 2 2 2 2 2 2 2 2 2 2 2 2 2 2 2 2 2
2 2 2 2 2 2 2 2 2 2 2 2 2 2 2 2 2 2 2 2 2 2 2 2 2 2 2 2 2 2 2 2 2 2 2 2 2 2 2 2 2 2 2 2 2 2 2 2 2 2
2 2 2 2 5 5 5 5 5 5 5 5 5 5 5 5 5 5 5 5 5 5 5 5 5 5 5 5 5 5 5 5 5 5 5 5 5 5 5 5 5 5 5 5 5 5 2 2 2 2
2 2 2 5 5 4 4 4 4 4 4 4 4 4 4 4 4 4 4 4 4 4 4 4 4 4 4 4 4 4 4 4 4 4 4 4 4 4 4 4 4 4 4 4 4 5 5 2 2 2
2 2 2 5 4 4 4 4 4 4 4 4 4 4 4 4 4 4 4 4 4 4 4 4 4 4 4 4 4 4 4 4 4 4 4 4 4 4 4 4 4 4 4 4 4 4 5 5 2 2
2 2 4 4 6 6 6 6 6 6 6 6 6 6 6 6 6 1 6 6 6 6 6 6 6 1 6 6 6 1 6 6 6 1 6 6 6 6 6 6 6 1 6 6 6 6 6 5 5 2
2 2 4 6 6 6 6 6 6 6 6 6 6 6 6 6 6 1 6 6 6 6 6 6 6 1 6 6 6 1 6 6 6 1 6 6 6 6 6 6 6 1 6 6 6 6 6 5 5 5
2 2 4 6 6 6 6 6 6 6 6 6 6 6 6 6 6 1 6 6 6 6 6 6 6 1 6 6 6 1 6 6 6 1 6 6 6 6 6 6 6 1 6 6 6 6 6 5 5 5
2 2 4 6 6 6 6 1 1 1 1 1 1 1 6 6 6 1 6 6 6 1 6 6 6 1 6 6 6 6 6 6 6 1 6 6 6 1 6 6 6 1 6 6 6 6 6 5 5 5
2 2 4 6 6 6 6 1 6 6 6 6 6 1 6 6 6 1 6 6 6 1 6 6 6 1 6 6 6 6 6 6 6 1 6 6 6 1 6 6 6 1 6 6 6 6 6 5 5 5
2 2 4 6 6 6 6 1 6 6 6 6 6 1 6 6 6 6 6 6 6 1 6 6 6 1 6 6 6 6 6 6 6 1 6 6 6 1 6 6 6 1 6 6 6 6 6 5 5 5
2 2 4 6 6 6 6 1 6 6 6 6 6 1 6 6 6 6 6 6 6 1 6 6 6 1 6 6 6 1 6 6 6 1 6 6 6 1 6 6 6 1 6 6 6 6 6 5 5 5
2 2 4 6 6 6 6 1 6 6 6 1 1 1 6 6 6 6 6 6 6 1 6 6 6 1 6 6 6 1 6 6 6 1 6 6 6 1 6 6 6 6 6 6 6 6 6 5 5 5
2 2 4 6 6 6 6 1 6 6 6 6 6 6 6 6 6 1 6 6 6 1 6 6 6 6 6 6 6 1 6 6 6 6 6 6 6 1 6 6 6 6 6 6 6 6 6 5 5 5
2 2 4 6 6 6 6 1 6 6 6 6 6 6 6 6 6 1 6 6 6 1 6 6 6 6 6 6 6 1 6 6 6 6 6 6 6 1 6 6 6 6 6 6 6 6 6 5 5 5
2 2 4 6 6 6 6 1 6 6 6 6 6 6 6 6 6 1 6 6 6 1 6 6 6 6 6 6 6 1 6 6 6 6 6 6 6 1 6 6 6 1 6 6 6 6 6 5 5 5
2 2 4 6 6 6 6 1 6 6 6 1 1 1 1 1 1 1 1 1 1 1 1 1 1 1 1 1 1 1 1 1 1 1 1 1 1 1 1 1 1 1 1 1 6 6 6 5 5 5
2 2 4 6 6 6 6 1 6 6 6 1 6 6 6 6 6 6 6 6 6 6 6 6 6 6 6 6 6 6 6 6 6 6 6 6 6 6 6 6 6 6 6 6 6 6 6 5 5 5
2 2 4 6 6 6 6 1 6 6 6 1 6 6 6 6 6 6 6 6 6 6 6 6 6 6 6 6 6 6 6 6 6 6 6 6 6 6 6 6 6 6 6 6 6 6 6 5 5 5
2 2 4 6 6 6 6 1 6 6 6 1 6 6 6 6 6 6 6 6 6 6 6 6 6 6 6 6 6 6 6 6 6 6 6 6 6 6 6 6 6 6 6 6 6 6 6 5 5 5
2 2 4 6 6 6 6 1 6 6 6 1 6 6 6 6 6 6 6 6 6 6 6 6 6 6 6 6 6 6 6 6 6 6 6 6 6 6 6 6 6 6 6 6 6 6 6 5 5 5
2 2 4 0 6 6 6 1 1 1 1 1 1 1 1 6 6 6 1 1 1 1 1 1 1 1 1 1 1 1 1 1 1 1 1 1 1 1 1 1 1 1 1 1 1 1 1 1 1 1
2 2 4 6 6 6 6 6 6 6 6 6 6 6 1 6 6 6 1 6 6 6 6 6 6 6 6 6 6 6 6 6 6 6 6 6 6 6 6 6 6 6 6 6 1 6 6 6 6 5
2 2 4 6 6 6 6 6 6 6 6 6 6 6 1 6 6 6 1 6 6 6 6 6 6 6 6 6 6 6 6 6 6 6 6 6 6 6 6 6 6 6 6 6 1 6 6 6 6 5
2 2 4 6 6 6 6 6 6 6 6 6 6 6 1 6 6 6 1 6 6 6 1 1 1 6 6 6 6 6 6 6 6 6 6 6 6 6 6 6 6 6 6 6 1 6 6 6 6 5
4 4 4 1 1 1 1 1 1 1 1 6 6 6 1 6 6 6 1 6 6 6 6 6 1 6 6 6 6 1 1 1 1 1 1 1 1 1 1 1 1 1 1 1 1 6 6 6 6 5
2 2 6 6 6 6 6 6 6 6 1 6 6 6 1 6 6 6 1 1 6 6 6 6 1 6 6 6 6 1 6 6 6 6 6 6 6 6 6 6 6 6 1 6 6 6 6 6 6 5
2 2 6 6 6 6 6 6 6 6 1 6 6 6 1 6 6 6 6 6 6 6 6 6 1 6 6 6 6 1 6 6 6 6 6 6 6 6 6 6 6 6 1 6 6 6 6 6 6 1
2 2 6 6 6 6 6 6 6 6 1 6 6 6 1 6 6 6 6 6 6 6 6 6 1 6 6 6 6 1 6 6 6 6 6 1 1 1 1 6 6 6 1 6 6 6 1 1 1 1
2 2 6 6 6 6 6 6 6 6 1 6 6 6 1 6 6 6 6 6 6 6 6 6 1 6 6 6 6 1 6 6 6 6 6 6 6 6 1 6 6 6 6 6 6 6 1 1 1 1
2 2 6 6 6 6 6 6 6 6 1 6 6 6 1 1 1 1 1 1 1 1 1 1 1 6 6 6 6 1 1 1 1 6 6 6 6 6 1 6 6 6 6 6 6 6 1 1 1 1
4 4 4 6 6 6 1 6 6 6 1 6 6 6 6 6 1 6 6 6 6 6 6 6 6 6 6 6 6 6 6 6 1 6 6 6 6 6 1 1 1 1 1 1 1 1 1 5 5 5
2 2 4 6 6 6 1 6 6 6 1 6 6 6 6 6 1 6 6 6 6 6 6 6 6 6 6 6 6 6 6 6 1 1 1 6 6 6 6 6 6 6 6 6 6 6 6 5 5 5
2 2 4 6 6 6 1 6 6 6 1 6 6 6 6 6 1 6 6 6 6 6 6 6 6 6 6 6 6 6 6 6 6 6 1 6 6 6 6 6 6 6 6 6 6 6 6 5 5 5
2 2 4 6 6 6 1 6 6 6 1 1 1 6 6 6 1 6 6 6 1 1 1 1 1 1 1 1 1 1 1 1 1 1 1 6 6 6 6 6 6 6 6 6 6 6 6 5 5 5
2 2 4 6 6 6 1 6 6 6 6 6 6 6 6 6 1 6 6 6 6 1 6 6 6 6 6 6 6 6 6 6 6 6 1 1 6 6 6 6 6 6 6 6 6 6 6 5 5 5
2 2 4 6 6 6 1 6 6 6 6 6 6 6 6 6 1 6 6 6 6 1 1 6 6 6 6 6 6 6 6 6 6 6 6 1 1 1 1 1 1 1 6 6 6 6 6 5 5 5
2 2 4 6 6 6 1 6 6 6 6 6 6 6 6 6 1 6 6 6 6 6 1 6 6 6 6 6 6 6 6 6 6 6 6 6 6 6 6 6 6 1 6 6 6 6 6 5 5 5
2 2 4 6 6 6 1 6 6 6 1 1 1 1 1 1 1 1 1 6 6 6 1 6 6 6 1 1 1 1 1 1 1 6 6 6 6 6 6 6 6 1 1 6 6 6 6 5 5 5
2 2 4 6 6 6 1 6 6 6 6 6 6 1 6 6 6 6 1 6 6 6 6 6 6 6 1 6 6 6 6 6 6 6 6 6 1 6 6 6 6 6 1 6 6 6 6 5 5 5
2 2 4 6 6 6 1 6 6 6 6 6 6 1 6 6 6 6 1 6 6 6 6 6 6 6 1 6 6 6 6 6 6 6 6 6 1 6 6 6 6 6 1 6 6 6 6 5 5 5
2 2 4 6 6 6 1 6 6 6 6 6 6 1 6 6 6 6 1 6 6 6 6 6 6 6 1 6 6 6 6 6 6 6 6 6 1 6 6 6 6 6 1 6 6 6 6 5 5 5
2 2 4 6 6 6 1 1 6 6 6 6 6 1 6 6 6 6 1 6 6 6 1 1 1 1 1 1 1 1 1 1 1 1 1 1 1 1 1 1 1 1 1 6 6 6 6 5 5 5
2 2 4 6 6 6 6 6 1 1 1 1 1 1 6 6 6 6 1 6 6 6 6 6 6 6 6 6 6 6 6 6 6 6 6 6 6 6 6 6 6 6 6 6 6 6 6 5 5 5
2 2 4 4 6 6 6 6 6 6 6 6 6 6 6 6 6 6 1 6 6 6 6 6 6 6 6 6 6 6 6 6 6 6 6 6 6 6 6 6 6 6 6 6 6 6 6 5 5 5
2 2 4 4 4 6 6 6 6 6 6 6 6 6 6 6 6 6 1 6 6 6 6 6 6 6 6 6 6 6 6 6 6 6 6 6 6 6 6 6 6 6 6 6 6 6 6 5 5 5
2 2 4 4 4 4 4 4 4 4 4 4 4 4 4 4 4 4 4 4 4 4 4 4 4 4 4 4 4 4 4 4 4 4 4 4 4 4 4 4 4 4 4 4 4 4 4 5 5 5
2 2 8 9 9 9 9 9 9 9 9 9 9 9 9 9 9 9 9 9 9 9 9 9 9 9 9 9 9 9 9 9 9 9 9 9 9 9 9 9 9 9 9 9 9 9 9 5 2 2
2 2 2 2 2 2 2 2 2 2 2 2 2 2 2 2 2 2 2 2 2 2 2 2 2 2 2 2 2 2 2 2 2 2 2 2 2 2 2 2 2 2 2 2 2 2 2 2 2 2
2 2 2 2 2 2 2 2 2 2 2 2 2 2 2 2 2 2 2 2 2 2 2 2 2 2 2 2 2 2 2 2 2 2 2 2 2 2 2 2 2 2 2 2 2 2 2 2 2 2
