12 12 12 12 12 12 12 12 12 12 12 12 12 12 12 12 12 12 12 12 12 12 12 12 12 12 12 12 12 12 12 12 12 12 12 12 12 12 12 12 12 12 12 12 12 12 12 12 12 12
12 12 12 12 12 12 12 12 12 12 12 12 12 12 12 12 12 12 12 12 12 12 12 12 12 12 12 12 12 12 12 12 12 12 12 12 12 12 12 12 12 12 12 12 12 12 12 12 12 12
12 12 12 12 12 12 12 12 12 12 12 12 12 12 12 12 12 12 12 12 12 12 12 12 12 12 12 12 12 12 12 12 12 12 12 12 12 12 12 12 12 12 12 12 12 12 12 12 12 12
12 12 12 12 12 12 12 15 15 12 15 15 15 15 15 15 15 12 12 12 12 12 12 12 15 15 15 15 15 15 12 12 12 12 12 12 12 12 12 12 12 12 12 12 12 12 12 12 12 12
12 12 12 15 15 15 15 15 15 15 15 15 15 15 15 15 15 15 15 15 15 15 15 15 15 15 15 15 15 15 15 15 15 15 15 15 15 15 15 15 15 15 15 15 15 15 12 12 12 12
12 12 12 15 15 15 15 15 15 15 15 15 15 15 15 15 15 15 15 15 15 15 15 15 15 15 15 15 15 15 15 15 15 15 15 15 15 15 15 15 15 15 15 15 15 15 15 12 12 12
12 12 12 15 15 16 16 16 16 16 16 16 16 16 16 16 16 16 16 16 16 16 16 16 16 16 16 16 16 16 16 16 16 16 16 16 16 16 16 16 16 16 16 16 16 16 15 12 12 12
12 12 12 15 15 16 10 11 11 11 11 11 11 11 11 11 11 11 11 11 11 11 15 11 11 11 11 11 11 11 11 11 11 11 11 15 11 11 11 11 11 11 11 11 11 16 15 12 12 12
12 12 15 15 15 16 10 11 10 10 10 10 10 10 11 11 11 11 11 11 11 11 15 11 11 11 11 11 11 11 11 11 11 11 11 15 11 11 11 11 11 11 11 11 11 16 15 12 12 12
12 12 12 15 15 16 10 11 10 11 11 11 11 11 11 11 11 11 11 11 11 11 15 11 11 11 11 11 11 11 11 11 11 11 11 15 11 11 11 11 11 11 11 11 11 16 15 12 12 12
12 12 12 15 15 16 10 11 10 11 15 15 15 15 15 15 15 15 15 10 11 10 15 15 15 15 15 15 10 10 10 15 11 11 11 15 10 10 11 15 15 15 10 11 11 16 16 15 12 12
12 12 12 15 15 15 16 11 10 11 15 11 11 11 11 11 11 11 11 11 11 10 15 11 11 11 11 11 11 11 10 15 11 11 11 11 11 11 11 15 11 11 11 11 11 16 16 15 12 12
12 12 12 15 15 15 16 11 10 11 15 11 11 11 11 11 11 11 11 11 11 10 15 11 11 11 11 11 11 11 10 15 11 11 11 11 11 11 11 15 11 11 11 11 11 15 16 15 12 12
12 12 15 15 15 15 16 11 10 11 15 11 11 11 15 15 15 15 15 15 15 15 15 11 11 11 11 11 11 11 10 15 11 11 11 11 11 11 11 15 11 11 11 11 11 16 16 15 12 12
12 12 15 15 15 16 16 11 10 11 15 11 11 11 11 11 11 11 11 11 11 11 15 11 11 11 15 15 15 15 15 15 15 15 15 15 15 15 15 15 15 15 11 11 11 16 15 15 12 12
12 12 15 15 15 15 16 11 10 11 15 11 11 11 11 11 11 11 11 11 11 11 15 11 11 11 15 11 11 11 11 11 11 11 11 11 11 11 11 11 11 15 11 11 11 16 15 15 12 12
12 12 12 15 15 15 16 11 10 11 15 11 11 11 11 11 11 11 11 11 11 11 15 11 11 11 15 11 11 11 11 11 11 11 11 11 11 11 11 11 11 15 11 11 11 16 15 15 12 12
12 12 12 15 15 15 16 11 11 11 15 15 15 15 15 15 15 15 15 11 11 11 15 11 11 11 15 15 15 15 15 15 15 15 15 15 15 11 11 11 11 15 11 11 11 16 15 12 12 12
12 12 12 15 15 15 16 11 11 11 11 11 11 11 11 11 11 11 16 11 11 11 15 11 11 11 11 11 11 11 11 11 11 11 11 11 15 11 11 11 11 15 11 11 11 16 15 15 12 12
12 12 12 15 15 15 16 11 11 11 11 11 11 11 11 11 11 11 16 11 11 11 15 11 11 11 11 11 11 11 11 11 11 11 11 11 15 10 11 10 11 15 11 11 11 16 15 15 15 12
12 16 16 15 15 15 16 11 11 11 11 11 11 11 11 11 11 11 16 11 11 11 15 11 11 11 11 11 11 11 11 11 11 11 11 10 15 11 11 11 11 11 10 10 10 16 16 16 16 16
12 15 15 15 15 15 16 15 15 15 15 15 15 15 15 11 11 11 15 11 11 11 15 15 15 15 15 15 15 15 15 15 15 11 11 10 15 11 11 11 11 10 10 10 10 15 10 10 10 10
12 15 15 15 15 15 16 11 11 11 11 11 11 11 15 11 11 11 15 11 11 11 11 11 11 11 11 11 15 11 11 11 15 11 10 10 15 11 10 10 10 10 10 10 10 15 10 10 10 10
12 15 15 15 15 15 16 11 11 11 11 11 11 11 15 11 11 11 15 11 11 11 11 11 11 11 11 11 15 11 11 11 15 11 10 10 15 10 10 10 10 10 10 10 10 15 10 10 10 10
12 15 15 15 15 15 16 10 10 10 10 10 10 10 15 11 11 11 15 11 11 11 11 11 11 11 11 11 15 11 11 11 15 11 10 10 15 10 10 10 15 15 15 15 15 15 10 10 10 10
12 15 18 10 10 10 10 10 10 10 10 10 10 10 15 11 11 11 15 11 11 11 15 15 15 15 15 15 15 11 11 11 15 11 10 10 15 10 10 10 10 10 10 10 10 10 10 10 10 10
12 15 18 10 10 10 10 10 10 10 10 10 10 10 15 11 11 11 15 11 11 11 11 11 11 11 11 11 11 11 11 11 15 11 11 10 15 10 10 10 10 10 10 10 10 10 10 10 10 10
12 15 18 10 10 10 10 10 10 10 15 10 10 10 15 11 11 11 15 11 11 11 11 11 11 11 11 11 11 11 11 11 15 11 10 10 15 10 10 10 10 10 10 10 10 10 10 10 10 10
12 15 18 18 18 18 10 10 10 10 15 10 10 10 15 11 11 11 15 11 11 11 11 11 11 11 11 11 11 11 11 11 15 11 10 10 15 15 15 15 15 15 15 10 10 10 16 16 16 16
12 15 15 15 15 15 15 10 10 10 15 10 10 10 15 11 11 11 15 15 15 15 15 15 15 15 15 15 15 11 11 11 15 11 11 11 11 11 11 11 11 11 11 11 18 10 16 15 15 12
12 16 16 16 16 16 16 10 10 10 15 10 10 10 15 11 11 11 15 11 11 11 11 11 10 10 10 11 11 11 11 11 15 11 11 11 11 11 11 11 11 11 11 11 18 10 16 15 12 12
12 13 12 12 13 12 16 10 10 10 15 10 10 10 15 11 11 11 15 11 11 11 11 11 11 11 11 11 11 11 11 11 15 11 11 11 11 11 11 11 11 11 11 11 18 10 16 15 15 12
12 13 12 13 12 12 16 10 10 10 15 10 10 10 15 11 11 11 15 11 11 11 11 11 11 11 11 11 11 11 11 11 15 11 11 11 11 11 11 11 11 11 11 11 18 10 16 15 15 12
12 13 12 12 13 12 16 10 10 10 15 10 10 10 15 11 11 11 15 11 11 11 15 15 15 15 15 15 15 15 15 15 15 15 15 15 15 15 11 11 11 15 11 11 11 10 16 15 15 12
13 12 13 12 13 12 16 10 10 10 15 10 10 10 19 11 11 11 15 11 11 11 11 11 11 11 11 11 11 11 11 11 15 11 11 11 11 11 11 11 11 15 11 11 11 11 16 15 12 12
12 13 12 12 13 12 16 10 10 10 15 10 10 10 19 11 11 11 15 11 11 11 11 11 11 11 11 11 11 11 11 11 15 11 11 11 11 11 11 11 11 15 11 11 11 11 16 15 12 12
12 13 12 12 13 12 16 10 10 10 15 10 10 10 11 11 11 11 15 11 11 11 11 11 11 11 11 11 11 11 11 11 15 11 11 11 11 11 11 11 11 15 11 11 11 11 16 15 15 12
12 12 13 12 12 12 16 10 10 10 15 15 15 15 15 15 15 15 15 10 10 10 15 15 15 15 15 15 15 11 11 11 15 10 10 10 15 15 15 15 15 15 11 11 10 11 16 15 15 12
12 13 12 12 13 12 16 10 10 10 10 10 10 10 11 11 15 11 11 11 11 11 11 11 11 11 15 11 11 11 11 11 19 11 11 11 15 11 11 11 11 11 11 11 11 11 16 15 15 12
13 13 12 13 12 12 16 10 10 10 10 10 10 10 11 11 15 11 11 11 11 11 11 11 11 11 15 11 11 11 11 11 19 11 11 11 15 11 11 11 11 11 11 11 11 11 16 15 15 12
12 12 12 12 12 12 16 10 10 10 10 10 10 10 11 11 15 11 11 11 11 11 11 11 11 11 15 11 11 11 11 11 19 11 11 11 15 11 11 11 11 11 11 11 11 11 16 15 15 12
12 12 12 12 12 12 16 16 16 16 16 16 16 16 16 16 16 16 16 16 16 16 16 16 16 16 16 16 16 16 16 16 16 16 16 16 16 16 16 16 16 16 16 16 16 16 16 15 15 12
12 12 12 12 12 12 17 17 17 17 17 17 17 17 17 17 17 17 17 17 17 17 17 17 17 17 17 17 17 17 17 17 17 17 17 17 17 17 17 17 17 17 17 17 17 17 17 12 12 12
12 12 12 12 12 12 12 12 12 12 12 12 12 12 12 12 12 12 12 12 12 12 12 12 12 12 12 12 12 12 12 12 12 12 12 12 12 12 12 12 12 12 12 12 12 12 12 12 12 12
12 12 12 12 12 12 12 12 12 12 12 12 12 12 12 12 12 12 12 12 12 12 12 12 12 12 12 12 12 12 12 12 12 12 12 12 12 12 12 12 12 12 12 12 12 12 12 12 12 12
12 12 12 12 12 12 12 12 12 12 12 12 12 12 12 12 12 12 12 12 12 12 12 12 12 12 12 12 12 12 12 12 12 12 12 12 12 12 12 12 12 12 12 12 12 12 12 12 12 12
12 12 12 12 12 12 12 12 12 12 12 12 12 12 12 12 12 12 12 12 12 12 12 12 12 12 12 12 12 12 12 12 12 12 12 12 12 12 12 12 12 12 12 12 12 12 12 12 12 12
12 12 12 12 12 12 12 12 12 12 12 12 12 12 12 12 12 12 12 12 12 12 12 12 12 12 12 12 12 12 12 12 12 12 12 12 12 12 12 12 12 12 12 12 12 12 12 12 12 12
12 12 12 12 12 12 12 12 12 12 12 12 12 12 12 12 12 12 12 12 12 12 12 12 12 12 12 12 12 12 12 12 12 12 12 12 12 12 12 12 12 12 12 12 12 12 12 12 12 12
12 12 12 12 12 12 12 12 12 12 12 12 12 12 12 12 12 12 12 12 12 12 12 12 12 12 12 12 12 12 12 12 12 12 12 12 12 12 12 12 12 12 12 12 12 12 12 12 12 12
