39 33 33 33 33 33 33 33 33 33 33 28 29 37 33 33 33 33 33 33 33 33 33 33 33 33 33 33 33 33 33 33 33 33 33 33 33 37 29 28 33 33 33 33 33 33 33 33 33 39
39 43 43 43 43 43 43 43 43 43 43 43 43 37 33 33 33 33 33 33 33 33 33 33 33 33 33 33 33 33 33 33 33 33 33 33 33 37 43 43 43 43 43 43 43 43 43 43 43 39
39 33 33 33 33 33 33 33 33 33 33 28 29 37 39 39 63 63 63 63 63 63 63 63 63 63 63 63 63 63 63 63 63 63 63 39 39 37 29 28 33 33 33 33 33 33 33 33 33 39
39 43 43 43 43 43 43 43 43 43 43 43 43 43 39 39 63 63 63 63 63 63 32 63 32 63 32 63 63 63 63 63 63 63 63 39 39 43 43 43 43 43 43 43 43 43 43 43 43 39
39 43 43 43 43 43 43 43 43 43 43 43 43 43 39 39 65 65 65 65 65 65 65 65 65 65 65 65 65 65 65 65 65 65 65 39 39 43 43 43 43 43 43 43 43 43 43 43 43 39
33 33 33 33 33 33 33 33 33 33 33 33 33 33 33 33 33 33 33 33 33 33 33 33 33 33 33 33 33 33 33 33 33 33 33 33 33 33 33 33 33 33 33 33 33 33 33 33 33 33
33 33 33 33 33 33 33 33 33 33 33 33 37 36 36 36 63 63 63 36 36 63 63 63 36 36 63 63 63 36 36 63 63 63 36 36 36 37 33 33 33 33 33 33 33 33 33 33 33 33
43 43 39 35 35 35 35 35 35 35 35 35 37 36 36 36 63 32 63 36 36 63 32 63 36 36 63 32 63 39 36 63 32 63 36 36 36 37 35 35 35 35 35 35 35 35 35 39 43 43
43 43 39 35 35 35 35 35 35 35 35 35 37 21 21 21 21 21 21 21 21 21 21 21 21 21 21 21 21 39 45 45 45 21 21 21 21 37 35 35 35 35 35 35 35 35 35 39 43 43
43 43 39 35 35 35 35 35 35 35 35 35 21 21 21 21 21 21 21 21 21 21 21 21 21 21 21 21 21 39 45 45 21 21 21 21 21 36 36 36 36 36 36 36 39 43 43 43 43 43
43 43 39 35 35 35 35 35 35 21 21 21 21 21 21 21 21 21 21 21 21 21 21 21 21 21 21 21 21 21 21 21 21 21 21 21 21 21 21 21 36 36 36 36 39 43 43 43 43 43
43 43 39 35 35 35 35 35 21 21 21 21 21 21 21 21 21 21 21 21 21 21 21 21 21 21 21 21 21 21 21 21 21 21 21 21 45 45 45 21 21 36 36 36 39 43 43 43 43 43
43 43 39 35 35 35 35 21 21 21 21 21 49 21 21 21 21 21 21 21 21 21 21 21 21 21 21 21 45 45 45 45 45 45 45 21 45 45 49 45 21 36 36 36 39 43 43 43 43 43
43 43 39 35 35 35 21 21 21 21 21 21 50 21 21 21 21 21 21 21 21 21 21 21 21 21 21 21 45 45 45 45 49 45 45 45 45 45 50 45 45 45 36 36 39 43 43 43 43 43
43 43 39 21 21 21 21 21 21 21 21 21 50 21 21 21 21 21 21 21 21 21 21 21 21 21 21 45 45 49 45 45 50 45 45 45 45 45 50 45 45 45 36 36 39 43 43 43 43 43
43 43 39 21 21 21 21 21 21 21 21 21 50 21 21 21 21 21 21 21 21 21 21 21 21 21 45 45 45 50 45 45 50 45 45 45 45 45 27 45 45 45 36 36 39 43 43 43 43 43
43 43 39 21 21 21 21 21 21 21 21 21 51 21 21 21 21 21 21 21 21 21 21 21 21 21 21 45 45 50 45 45 50 45 45 45 45 45 45 45 45 45 36 36 39 43 43 43 43 43
43 43 39 21 21 21 21 21 21 21 21 21 21 21 21 21 21 49 21 21 21 21 21 21 21 21 21 21 45 51 45 45 51 45 45 45 45 45 45 45 45 45 36 36 39 43 43 43 43 43
43 43 39 21 21 21 21 21 21 21 21 21 21 21 21 21 21 50 21 21 21 21 21 21 21 21 21 21 45 33 33 33 33 33 33 33 33 33 33 33 33 33 33 33 39 43 43 43 43 43
43 43 39 21 21 21 21 21 21 21 21 21 21 21 21 21 21 50 21 21 21 21 21 21 21 21 21 45 45 29 29 29 29 29 29 29 29 29 29 29 29 29 29 36 39 43 43 43 43 43
43 43 39 21 21 21 21 21 21 21 21 21 21 21 21 21 21 50 21 21 21 21 21 21 21 21 21 45 45 29 29 29 29 29 29 29 29 29 29 29 29 29 29 36 39 43 43 43 43 43
43 43 39 21 21 21 21 21 21 21 21 21 21 21 21 21 21 50 21 21 21 21 21 21 21 21 21 21 21 21 21 21 21 21 21 21 21 21 21 21 21 21 21 21 33 33 39 43 43 43
43 43 39 21 45 45 45 21 21 45 21 21 21 21 21 21 21 50 21 21 21 21 21 21 21 21 21 21 21 21 21 21 21 21 21 21 21 21 21 21 21 21 21 21 21 21 39 43 43 43
43 43 21 45 45 21 45 45 21 45 21 21 21 21 21 21 21 51 21 21 21 21 21 21 21 21 21 49 21 21 21 21 21 21 21 21 21 21 21 21 45 45 45 45 45 21 39 43 43 43
43 43 21 45 45 45 45 45 21 21 21 21 21 21 21 21 21 21 21 21 21 21 21 21 21 21 21 50 21 21 21 21 21 21 21 21 21 21 21 21 21 45 45 45 45 45 39 43 43 43
43 43 21 45 45 45 45 45 21 45 21 21 21 21 21 21 21 21 21 21 21 21 21 21 21 21 21 50 21 21 21 21 21 21 21 21 21 21 21 21 21 21 45 45 45 45 39 43 43 43
43 43 21 21 45 45 45 21 45 21 21 21 21 21 21 21 21 21 21 21 21 21 21 21 21 21 21 50 21 21 21 21 21 21 21 21 21 21 21 21 21 21 45 45 45 45 45 43 43 43
43 43 21 21 45 45 45 45 21 21 21 21 21 21 21 21 21 21 21 21 21 21 21 21 21 21 21 51 21 21 21 21 21 21 21 21 21 21 21 21 21 21 45 45 45 45 45 43 43 43
43 43 21 21 21 21 21 21 21 21 21 21 21 21 21 21 21 21 21 21 21 21 21 21 21 21 21 21 21 21 21 21 21 21 21 21 21 21 21 21 21 21 45 45 45 45 45 43 43 43
43 43 21 21 21 21 21 21 21 21 21 21 21 21 21 21 21 21 21 21 21 21 21 21 21 21 21 21 21 21 21 21 21 21 21 21 21 21 21 21 45 45 45 45 45 45 45 43 43 43
43 43 39 21 21 21 21 21 21 21 21 21 21 21 21 21 21 21 21 21 21 21 21 21 21 21 21 21 21 21 21 21 21 21 21 21 21 21 21 21 45 45 45 45 45 45 45 43 43 43
43 43 39 21 21 21 21 21 21 21 21 21 21 49 21 21 21 21 21 21 21 21 21 21 21 21 21 21 21 21 21 21 21 21 21 21 21 49 21 21 21 45 45 45 45 45 39 43 43 43
43 43 39 21 21 21 21 21 21 21 21 21 21 50 21 21 21 21 21 21 21 21 21 21 49 21 21 21 21 21 21 21 21 21 21 21 21 50 21 21 21 21 21 21 45 45 39 43 43 43
43 43 39 21 21 21 21 21 21 21 21 21 21 50 21 21 21 21 21 21 21 21 21 21 50 21 21 21 21 21 21 21 21 21 21 21 21 50 21 21 21 21 21 21 21 21 39 43 43 43
43 43 39 21 21 21 21 21 21 21 21 21 21 50 21 21 21 21 21 21 21 21 21 21 50 21 21 21 21 21 21 21 21 21 21 21 21 50 21 21 21 21 21 21 21 21 39 43 43 43
43 43 39 21 21 21 21 21 21 21 21 21 21 50 21 21 21 21 21 21 21 21 21 21 50 21 21 21 21 21 21 21 21 21 21 21 21 50 21 21 21 21 21 21 21 21 39 43 43 43
43 43 39 21 21 21 21 21 21 21 21 21 21 51 21 21 21 21 21 21 21 21 21 21 50 21 21 21 21 21 21 21 21 21 21 21 21 51 21 21 21 21 21 21 21 21 39 43 43 43
43 43 39 21 21 21 21 21 21 21 21 21 21 21 21 21 21 21 21 21 21 21 21 21 51 21 21 21 21 21 21 21 21 21 21 21 21 21 21 21 21 21 21 21 21 45 39 43 43 43
43 43 39 21 21 21 21 21 21 21 21 21 21 21 21 21 21 21 21 21 21 21 21 21 21 21 21 21 21 21 21 21 21 21 21 21 21 21 21 21 21 21 21 21 21 45 39 43 43 43
43 43 39 21 21 21 21 21 21 21 21 21 21 21 21 21 21 21 21 21 21 21 21 21 21 21 21 21 21 21 21 21 21 21 21 21 45 45 45 45 21 21 21 21 21 45 39 43 43 43
43 43 39 45 21 21 21 21 21 21 21 45 21 21 21 21 21 21 21 21 21 21 21 21 21 21 21 21 21 21 21 21 21 21 21 45 45 45 45 45 21 21 21 21 45 45 39 43 43 43
43 43 39 45 21 21 21 21 21 21 45 45 45 45 21 21 21 21 21 21 21 21 21 21 21 21 21 21 21 21 21 21 21 21 45 45 45 45 45 45 45 21 21 45 45 45 33 33 33 33
43 43 39 45 45 45 45 45 21 45 21 45 45 45 45 21 21 21 21 21 21 21 21 21 21 21 21 21 21 21 21 21 45 45 45 45 45 45 45 45 45 21 45 45 45 38 38 38 38 38
43 43 39 33 33 10 45 45 21 45 45 45 45 45 45 21 21 21 21 21 21 21 21 21 21 21 21 21 21 21 21 21 21 21 21 45 45 45 45 45 45 45 45 38 38 38 38 38 38 38
38 43 43 43 43 39 45 45 45 45 45 45 45 45 45 45 45 45 38 38 38 38 38 38 38 38 38 38 38 38 38 38 38 38 38 38 38 45 45 38 38 38 38 38 38 38 38 38 38 38
38 38 38 38 38 38 38 38 38 38 37 45 45 36 36 36 36 38 38 38 38 38 38 38 38 38 38 38 38 38 38 38 38 38 38 37 37 45 45 36 36 38 38 38 38 38 38 38 38 38
38 38 38 38 38 38 38 38 38 38 37 45 45 36 36 36 36 38 38 38 38 38 38 38 38 38 38 38 38 38 38 38 38 38 38 37 37 45 45 36 36 38 38 38 38 38 38 38 38 38
38 38 38 38 38 38 38 38 38 38 37 45 45 36 36 36 36 38 38 38 38 38 38 38 38 38 38 38 38 38 38 38 38 38 38 37 37 45 45 36 36 38 38 38 38 38 38 38 38 38
38 38 38 38 38 38 38 38 38 38 37 45 45 36 36 36 36 38 38 38 38 38 38 38 38 38 38 38 38 38 38 38 38 38 38 37 36 36 36 36 36 36 38 38 38 38 38 38 38 38
38 38 38 38 38 38 38 38 38 38 38 45 45 45 36 36 36 38 38 38 38 38 38 38 38 38 38 38 38 38 38 38 38 38 38 36 36 36 36 36 35 36 38 38 38 38 38 38 38 38
